5
6
2 2 3 3 1 1
2 5 2 3 1 1
1 1 1 2 1 1
1 1 1 1 4 4
1 1 1 1 4 4